
II_WEA_SWO_BOBOKU	II_WEA_SWO_PARMIL
II_WEA_AXE_LUDA	II_WEA_AXE_RODNEY
II_WEA_SWO_FALL	II_WEA_SWO_CLIP
II_WEA_AXE_FALL	II_WEA_AXE_DRONE
II_WEA_KNU_FALL	II_WEA_KNU_XENO

II_WEA_CHE_DEVOTION	II_WEA_CHEE_PLIM
II_WEA_WAN_WANDMULE
II_WEA_WAN_FIRE	II_WEA_WAN_ZEREM
II_WEA_BOW_BOW15	II_WEA_BOW_CRISTI
II_WEA_BOW_BOW30	II_WEA_BOW_CURUSI
II_WEA_BOW_BOW45	II_WEA_BOW_VARIFE
II_WEA_YOY_YOY45	II_WEA_YOY_REPOYI
II_WEA_YOY_YOY30	II_WEA_YOY_FIREE
II_WEA_YOY_YOY15	II_WEA_YOY_DICEIN
II_WEA_STA_STA45	II_WEA_STA_SHEIKANE
II_WEA_STA_FLAM	II_WEA_STA_TEBA
II_WEA_STA_STA30	II_WEA_STA_SLINE
II_WEA_STA_STA15	II_WEA_STA_SIGN
II_WEA_WAN_WAN45	II_WEA_WAN_MIRAGE
II_WEA_WAN_WAN30	II_WEA_WAN_NAZ
II_WEA_WAN_WAN15	II_WEA_WAN_KALIS
II_WEA_CHE_IBLLINESS
II_WEA_CHE_SUHOUM
II_WEA_CHEE_CHE15	II_WEA_CHEE_BAREM
II_WEA_CHEE_SAINT
II_WEA_CHEE_GRIM	II_WEA_CHEE_SAYRAM
II_WEA_AXE_BRONZE
II_WEA_AXE_CURNING
II_WEA_SWO_PENEL2
